00000000000000000000
00000000000000000000
00000000000000000000
00000000000000000000
00000000000000000000
00000111111111100000
00000152322224100000
00000111111111100000
00000000000000000000
00000000000000000000
00000000000000000000
00000000000000000000