00000000000000000000
00000000000000000000
00000111111111100000
00000122221522110000
00000122222322210000
00000122221322110000
00000122221222100000
00000122221224100000
00000122221224100000
00000111111111100000
00000000000000000000
00000000000000000000