00001111111111110000
00001222522211110000
00001222332211110000
00001121232222210000
00001232222222210000
00001222111111110000
00001122111111110000
00001242222222210000
00001212222222210000
00001442222222410000
00001111111111110000
00000000000000000000