00000000000000000000
00000000000000000000
00000111111111110000
00000125222144410000
00000122222332210000
00000122223222110000
00000122222111110000
00000122221111110000
00000122221111110000
00000111111111110000
00000000000000000000
00000000000000000000